5 5 5 5 5 5 5 5 5 5 5 5 5 5 5 5 5
5 0 0 5 9 5 0 0 0 0 0 0 0 0 0 0 5
5 0 0 0 0 0 0 0 0 0 0 0 0 0 0 0 5
5 0 0 0 0 0 0 0 0 0 0 0 0 0 0 0 5
5 0 0 0 0 0 0 0 0 0 0 0 0 0 0 0 5
5 0 0 0 0 5 5 5 5 5 0 0 0 1 0 0 5
5 0 0 0 0 5 11 0 0 0 0 0 0 2 0 0 5
5 0 0 0 0 5 5 5 5 5 0 0 0 3 0 0 5
5 0 0 0 0 0 6 7 8 0 0 0 0 0 0 0 5
5 0 0 0 0 5 5 5 5 5 0 0 0 0 0 0 5
5 0 0 0 0 0 0 0 0 0 0 0 0 0 0 0 5
5 0 0 0 0 0 0 0 0 0 0 0 0 0 0 0 5
5 0 0 0 0 0 0 0 0 0 0 0 0 0 0 0 5
5 0 0 0 0 0 0 0 0 0 0 0 0 0 0 0 5
5 0 0 0 0 0 0 0 0 0 0 0 0 0 0 0 5
5 0 0 0 0 0 0 0 0 0 0 5 10 5 0 0 5
5 5 5 5 5 5 5 5 5 5 5 5 5 5 5 5 5