4 4 4 4 4 4 4 4 4 4 4 4 4 4 4 4 4
4 4 4 4 5 5 5 5 5 5 5 4 4 4 4 4 4
4 4 4 4 5 0 0 0 0 0 5 4 4 4 4 4 4
4 4 4 4 5 0 8 1 0 0 5 4 4 4 4 4 4
4 4 4 4 5 0 0 0 0 0 5 4 4 4 4 4 4
4 4 4 4 5 0 0 0 0 0 5 4 4 4 4 4 4
5 5 5 5 5 0 0 0 0 0 5 5 5 5 5 5 4
5 0 6 0 0 0 0 0 0 0 0 0 0 0 0 5 4
5 0 2 0 0 0 9 10 11 0 0 0 0 3 0 5 4
5 0 0 0 0 0 0 0 0 0 0 0 0 0 0 5 4
5 5 5 5 5 0 0 0 0 0 5 5 5 5 5 5 4
4 4 4 4 5 0 0 0 0 0 5 4 4 4 4 4 4
4 4 4 4 5 0 0 0 0 0 5 4 4 4 4 4 4
4 4 4 4 5 0 0 7 0 0 5 4 4 4 4 4 4
4 4 4 4 5 0 0 0 0 0 5 4 4 4 4 4 4
4 4 4 4 5 5 5 5 5 5 5 4 4 4 4 4 4
4 4 4 4 4 4 4 4 4 4 4 4 4 4 4 4 4