4 4 4 4 4 4 4 4 4 4 4 4 4 4 4 4 4
4 4 4 4 4 4 4 4 4 4 4 4 4 4 4 4 4
4 4 4 4 4 4 4 4 4 4 4 4 4 4 4 4 4
4 4 4 4 4 4 4 4 4 4 4 4 4 4 4 4 4
4 4 4 5 5 5 5 5 5 5 5 5 4 4 4 4 4
4 4 4 5 0 0 0 0 0 0 0 5 4 4 4 4 4
4 4 4 5 0 0 1 2 3 0 0 5 4 4 4 4 4
4 4 4 5 0 0 0 0 0 0 0 5 4 4 4 4 4
4 4 4 5 0 0 6 7 8 0 0 5 4 4 4 4 4
4 4 4 5 0 0 0 0 0 0 0 5 4 4 4 4 4
4 4 4 5 0 0 9 10 11 0 0 5 4 4 4 4 4
4 4 4 5 0 0 0 0 0 0 0 5 4 4 4 4 4
4 4 4 5 5 5 5 5 5 5 5 5 4 4 4 4 4
4 4 4 4 4 4 4 4 4 4 4 4 4 4 4 4 4
4 4 4 4 4 4 4 4 4 4 4 4 4 4 4 4 4
4 4 4 4 4 4 4 4 4 4 4 4 4 4 4 4 4
4 4 4 4 4 4 4 4 4 4 4 4 4 4 4 4 4