4 4 4 4 4 4 4 4 4 4 4 4 4 4 4 4 4
4 4 4 4 4 4 4 4 4 4 4 4 4 4 4 4 4
4 4 4 4 4 4 4 4 4 4 4 4 4 4 4 4 4
4 4 4 4 4 4 4 4 4 4 4 4 4 4 4 4 4
4 4 4 5 5 5 5 5 5 5 5 5 4 4 4 4 4
4 4 4 5 0 1 0 2 0 3 0 5 4 4 4 4 4
4 4 4 5 0 0 5 0 5 0 0 5 4 4 4 4 4
4 4 4 5 0 0 0 0 0 0 0 5 4 4 4 4 4
4 4 4 5 0 0 0 0 0 0 0 5 4 4 4 4 4
4 4 4 5 0 5 6 7 8 5 0 5 4 4 4 4 4
4 4 4 5 0 0 0 0 0 0 0 5 4 4 4 4 4
4 4 4 5 0 0 9 10 11 0 0 5 4 4 4 4 4
4 4 4 5 5 5 5 5 5 5 5 5 4 4 4 4 4
4 4 4 4 4 4 4 4 4 4 4 4 4 4 4 4 4
4 4 4 4 4 4 4 4 4 4 4 4 4 4 4 4 4
4 4 4 4 4 4 4 4 4 4 4 4 4 4 4 4 4
4 4 4 4 4 4 4 4 4 4 4 4 4 4 4 4 4