0 0 0 0 0 0 0 0 0 0 0 0 0 0 0 0
0 1 1 1 1 1 0 2 0 1 1 1 1 1 0 0
0 1 1 1 1 1 0 1 0 1 1 1 1 1 0 0
0 0 0 0 0 1 0 6 0 1 0 0 0 0 0 0
0 1 1 1 0 0 0 1 0 0 0 1 1 1 0 0
0 1 14 1 1 1 1 3 1 1 1 1 11 1 0 0
0 1 1 1 0 0 0 1 0 0 0 1 1 1 0 0
0 0 0 0 0 1 0 9 0 1 0 0 0 0 0 0
0 1 1 1 1 1 0 1 0 1 1 1 1 1 0 0
0 1 1 1 1 1 0 4 0 1 1 1 1 1 0 0
0 0 0 0 0 0 0 0 0 0 0 0 0 0 0 0