4 4 4 4 4 4 4 4 4 4 4 4 4 4 4 4 4
4 4 4 4 4 4 4 4 4 4 4 4 4 4 4 4 4
4 4 4 4 4 4 4 4 4 4 4 4 4 4 4 4 4
4 4 4 4 4 4 4 4 4 4 4 4 4 4 4 4 4
4 4 4 5 5 5 5 5 5 5 5 5 4 4 4 4 4
4 4 4 5 0 0 0 2 0 0 0 5 4 4 4 4 4
4 4 4 5 0 5 5 0 5 5 0 5 4 4 4 4 4
4 4 4 5 1 5 0 0 0 5 3 5 4 4 4 4 4
4 4 4 5 0 0 0 0 0 0 0 5 4 4 4 4 4
4 4 4 5 0 5 6 7 8 5 0 5 4 4 4 4 4
4 4 4 5 0 0 0 0 0 0 0 5 4 4 4 4 4
4 4 4 5 0 0 9 10 11 0 0 5 4 4 4 4 4
4 4 4 5 5 5 5 5 5 5 5 5 4 4 4 4 4
4 4 4 4 4 4 4 4 4 4 4 4 4 4 4 4 4
4 4 4 4 4 4 4 4 4 4 4 4 4 4 4 4 4
4 4 4 4 4 4 4 4 4 4 4 4 4 4 4 4 4
4 4 4 4 4 4 4 4 4 4 4 4 4 4 4 4 4