4 4 4 4 4 4 4 4 4 4 4 4 4 4 4 4 4
4 4 4 4 4 4 4 4 4 4 4 4 4 4 4 4 4
4 4 4 4 4 4 4 4 4 4 4 4 4 4 4 4 4
4 4 4 4 4 4 4 4 4 4 4 4 4 4 4 4 4
4 4 4 5 5 5 5 5 5 5 5 5 4 4 4 4 4
4 4 4 5 9 0 0 6 0 0 0 5 4 4 4 4 4
4 4 4 5 0 0 5 0 5 0 1 5 4 4 4 4 4
4 4 4 5 0 0 0 0 0 0 0 5 4 4 4 4 4
4 4 4 5 2 5 0 0 7 0 10 5 4 4 4 4 4
4 4 4 5 0 5 0 0 0 0 5 5 4 4 4 4 4
4 4 4 5 3 0 5 0 0 5 0 5 4 4 4 4 4
4 4 4 5 0 0 0 8 0 0 11 5 4 4 4 4 4
4 4 4 5 5 5 5 5 5 5 5 5 4 4 4 4 4
4 4 4 4 4 4 4 4 4 4 4 4 4 4 4 4 4
4 4 4 4 4 4 4 4 4 4 4 4 4 4 4 4 4
4 4 4 4 4 4 4 4 4 4 4 4 4 4 4 4 4
4 4 4 4 4 4 4 4 4 4 4 4 4 4 4 4 4