4 4 4 4 4 4 4 4 4 4 4 4 4 4 4 4 4
4 4 4 4 4 4 4 4 4 4 4 4 4 4 4 4 4
4 4 4 4 4 4 4 4 4 4 4 4 4 4 4 4 4
4 4 4 4 4 4 4 4 4 4 4 4 4 4 4 4 4
4 4 4 5 5 5 5 5 5 5 5 5 4 4 4 4 4
4 4 4 5 0 0 0 0 0 0 0 5 4 4 4 4 4
4 4 4 5 0 9 0 6 0 1 0 5 4 4 4 4 4
4 4 4 5 0 0 0 0 0 0 0 5 4 4 4 4 4
4 4 4 5 0 2 5 0 7 0 10 5 4 4 4 4 4
4 4 4 5 0 0 0 0 0 0 0 5 4 4 4 4 4
4 4 4 5 0 0 0 0 0 0 0 5 4 4 4 4 4
4 4 4 5 0 3 0 8 0 11 0 5 4 4 4 4 4
4 4 4 5 5 5 5 5 5 5 5 5 4 4 4 4 4
4 4 4 4 4 4 4 4 4 4 4 4 4 4 4 4 4
4 4 4 4 4 4 4 4 4 4 4 4 4 4 4 4 4
4 4 4 4 4 4 4 4 4 4 4 4 4 4 4 4 4
4 4 4 4 4 4 4 4 4 4 4 4 4 4 4 4 4